65,65,65,65,65,65,65,65,65,10,12,11,12,11,12,11,12,11,12,11,12,11,12,11,12,11,12,11,12,11,12,11,12,11,12,11,12,11,12,11,13,65,65,65,65,65,65,65,65,65
65,65,65,65,65,65,65,65,65,20,22,21,22,56,57,21,22,56,57,21,22,22,21,22,56,57,21,22,56,57,21,22,22,56,57,22,56,57,57,56,23,65,65,65,65,65,65,65,65,65
65,65,65,10,11,11,11,11,12,14,32,32,32,32,32,32,32,32,32,32,32,32,32,32,32,32,32,32,32,32,32,32,31,32,32,32,32,32,32,32,15,11,12,11,11,12,13,65,65,65
65,65,65,20,21,22,22,21,57,24,32,32,35,42,41,42,41,42,41,42,41,42,34,32,32,32,32,35,41,42,41,42,41,42,41,42,41,34,32,32,25,56,57,56,57,56,23,65,65,65
65,65,65,30,32,32,32,32,32,32,32,32,15,11,12,13,10,11,12,13,10,12,14,32,32,32,32,15,12,13,10,11,12,13,10,11,12,14,32,32,32,32,32,32,32,32,23,65,65,65
65,65,65,20,32,32,32,32,32,32,32,32,25,21,22,23,20,21,21,15,14,21,24,32,29,19,32,25,21,15,14,56,57,23,20,21,22,24,32,32,32,32,32,32,32,31,33,65,65,65
65,65,65,30,32,32,35,41,42,34,32,32,32,32,32,33,30,44,45,25,24,32,32,39,18,18,29,32,32,25,24,44,45,23,30,32,32,32,32,32,35,41,42,34,32,32,23,65,65,65
65,10,11,14,32,32,15,12,13,20,31,32,32,32,32,23,20,54,55,32,32,32,32,32,18,18,32,32,32,32,32,54,55,23,20,32,32,32,32,32,33,65,65,20,32,32,33,65,65,65
65,20,21,24,32,32,25,22,23,40,41,41,34,32,32,33,40,41,34,32,32,32,32,32,19,18,32,32,32,32,32,35,42,43,30,32,32,35,41,42,43,65,65,30,32,32,23,65,65,65
65,30,16,32,32,32,32,17,23,65,65,65,20,32,32,23,65,65,20,32,32,32,32,32,18,18,32,32,32,32,32,23,65,65,20,32,32,23,65,65,65,65,65,30,32,32,33,65,65,65
65,20,32,32,32,32,32,32,33,65,65,65,30,32,32,33,65,65,30,32,32,32,32,32,18,18,32,32,32,32,32,33,65,65,30,32,32,33,65,10,11,11,12,14,32,32,23,65,65,65
65,30,32,32,36,37,32,32,23,65,65,65,20,32,32,23,65,65,20,32,32,32,32,32,18,18,32,32,32,32,32,23,65,65,30,32,32,23,65,20,21,57,22,24,32,32,33,65,65,65
65,20,32,32,46,47,32,32,33,65,65,65,30,32,32,33,65,65,30,32,28,32,32,32,18,18,32,31,32,32,32,23,65,65,20,32,32,33,65,20,32,32,32,32,32,32,23,65,65,65
65,30,32,32,32,32,32,32,23,65,65,65,20,32,32,23,65,65,20,32,32,32,32,32,18,18,32,32,32,32,32,23,65,65,30,32,32,23,65,30,32,32,32,32,32,32,33,65,65,65
65,30,26,32,32,32,32,27,33,65,65,65,30,32,32,33,65,65,30,32,32,32,32,32,18,18,32,32,32,32,32,33,65,65,20,32,32,33,66,20,32,32,35,41,42,42,43,65,65,65
65,40,41,42,41,42,41,42,43,65,65,65,20,32,32,23,10,12,14,32,32,32,32,32,18,18,32,32,32,32,32,15,12,13,30,32,32,23,66,30,32,32,33,65,65,65,65,65,65,65
65,65,65,65,65,65,65,65,65,65,65,65,30,32,32,33,20,56,24,32,32,32,32,32,18,18,32,28,32,32,32,25,56,23,20,32,32,33,66,20,32,32,15,11,12,11,12,13,65,65
65,65,65,65,65,65,65,65,65,65,65,65,20,32,32,23,20,44,45,32,32,32,32,32,18,18,32,32,32,32,32,44,45,23,30,32,32,23,66,30,32,32,25,21,22,21,22,23,65,65
64,65,65,65,65,65,65,65,65,65,65,65,30,28,32,33,30,54,55,32,32,32,32,32,18,18,32,32,32,32,32,54,55,33,20,32,32,33,66,20,18,18,18,18,18,18,18,23,65,65
64,64,65,65,64,64,65,65,65,65,65,65,20,32,32,23,40,41,42,41,42,41,42,34,36,37,35,41,42,41,42,41,42,43,30,32,32,23,66,30,18,18,18,18,18,18,18,33,65,65
64,65,65,65,65,65,65,65,65,65,65,65,30,32,32,15,11,12,11,12,12,11,12,14,46,47,15,11,12,11,12,11,11,12,14,32,32,33,66,20,18,18,18,18,18,18,18,23,65,65
64,65,65,65,65,65,65,65,65,65,65,65,20,32,32,25,56,57,56,22,21,56,57,24,32,32,25,56,22,56,57,22,56,57,24,28,32,23,66,30,18,18,18,18,18,18,18,33,65,65
65,64,65,65,65,65,65,65,64,64,64,64,30,32,32,32,32,32,32,32,32,32,32,32,32,32,32,32,32,32,32,32,32,32,32,32,32,33,66,20,18,18,18,18,19,18,18,23,65,65
65,64,64,65,65,65,65,64,64,64,64,64,40,41,42,42,42,41,42,41,42,41,42,34,32,32,35,41,42,41,42,41,42,41,42,41,42,43,66,30,18,18,18,18,18,18,18,33,65,65
65,64,64,64,65,64,64,64,64,64,64,65,65,65,65,65,65,65,65,65,65,65,65,40,41,42,43,66,66,66,66,66,66,66,66,66,66,66,66,40,41,42,41,42,41,42,42,43,65,65

0,0,0,0,0,0,0,0,0,0,0,0,0,0,0,0,0,0,0,0,0,0,0,0,0,0,0,0,0,0,0,0,0,0,0,0,0,0,0,0,0,0,0,0,0,0,0,0,0,0
0,0,0,0,0,0,0,0,0,0,1,1,1,1,1,1,1,1,1,1,1,1,1,1,1,1,1,1,1,1,1,1,1,1,1,1,1,1,1,1,0,0,0,0,0,0,0,0,0,0
0,0,0,0,0,0,0,0,0,1,0,0,0,0,0,0,0,0,0,0,0,0,0,0,0,0,0,0,0,0,0,0,0,0,0,0,0,0,0,0,1,0,0,0,0,0,0,0,0,0
0,0,0,0,1,1,1,1,1,1,0,0,1,1,1,1,1,1,1,1,1,1,1,0,0,0,0,1,1,1,1,1,1,1,1,1,1,1,0,0,1,1,1,1,1,1,0,0,0,0
0,0,0,1,0,0,0,0,0,0,0,0,0,0,0,0,0,0,0,0,0,0,1,0,0,0,0,1,0,0,0,0,0,0,0,0,0,1,0,0,0,0,0,0,0,0,1,0,0,0
0,0,0,1,0,0,0,0,0,0,0,0,1,1,1,0,0,1,1,0,0,1,1,0,0,0,0,1,1,0,0,1,1,0,0,1,1,1,0,0,0,0,0,0,0,0,1,0,0,0
0,0,0,1,0,0,1,1,1,1,0,0,0,0,0,1,1,0,0,1,1,0,0,0,0,0,0,0,0,1,1,0,0,1,1,0,0,0,0,0,1,1,1,1,0,0,1,0,0,0
0,0,0,1,0,0,1,0,0,1,0,0,0,0,0,1,1,0,0,0,0,0,0,0,0,0,0,0,0,0,0,0,0,1,1,0,0,0,0,0,1,0,0,1,0,0,1,0,0,0
0,0,1,1,0,0,1,1,0,0,1,1,1,0,0,1,0,1,1,0,0,0,0,0,0,0,0,0,0,0,0,1,1,1,1,0,0,1,1,1,0,0,0,1,0,0,1,0,0,0
0,1,0,0,0,0,0,0,1,0,0,0,1,0,0,1,0,0,1,0,0,0,0,0,0,0,0,0,0,0,0,1,0,0,1,0,0,1,0,0,0,0,0,1,0,0,1,0,0,0
0,1,0,0,0,0,0,0,1,0,0,0,1,0,0,1,0,0,1,0,0,0,0,0,0,0,0,0,0,0,0,1,0,0,1,0,0,1,0,0,0,0,0,1,0,0,1,0,0,0
0,1,0,0,0,0,0,0,1,0,0,0,1,0,0,1,0,0,1,0,0,0,0,0,0,0,0,0,0,0,0,1,0,0,1,0,0,1,0,0,1,1,1,1,0,0,1,0,0,0
0,1,0,0,0,0,0,0,1,0,0,0,1,0,0,1,0,0,1,0,0,0,0,0,0,0,0,0,0,0,0,1,0,0,1,0,0,1,0,1,0,0,0,0,0,0,1,0,0,0
0,1,0,0,0,0,0,0,1,0,0,0,1,0,0,1,0,0,1,0,0,0,0,0,0,0,0,0,0,0,0,1,0,0,1,0,0,1,0,1,0,0,0,0,0,0,1,0,0,0
0,1,0,0,0,0,0,0,1,0,0,0,1,0,0,1,0,0,1,0,0,0,0,0,0,0,0,0,0,0,0,1,0,0,1,0,0,1,0,1,0,0,1,1,1,1,0,0,0,0
0,0,1,1,1,1,1,1,0,0,0,0,1,0,0,1,0,0,1,0,0,0,0,0,0,0,0,0,0,0,0,1,0,0,1,0,0,1,0,1,0,0,1,0,0,0,0,0,0,0
0,0,0,0,0,0,0,0,0,0,0,0,1,0,0,1,1,1,1,0,0,0,0,0,0,0,0,0,0,0,0,1,1,1,1,0,0,1,0,1,0,0,1,0,0,0,0,0,0,0
0,0,0,0,0,0,0,0,0,0,0,0,1,0,0,1,1,0,0,0,0,0,0,0,0,0,0,0,0,0,0,0,0,1,1,0,0,1,0,1,0,0,1,1,1,1,1,0,0,0
0,0,0,0,0,0,0,0,0,0,0,0,1,0,0,1,1,0,0,0,0,0,0,0,0,0,0,0,0,0,0,0,0,1,1,0,0,1,0,1,0,0,0,0,0,0,0,1,0,0
0,0,0,0,0,0,0,0,0,0,0,0,1,0,0,1,0,1,1,1,1,1,1,1,0,0,1,1,1,1,1,1,1,0,1,0,0,1,0,1,0,0,0,0,0,0,0,1,0,0
0,0,0,0,0,0,0,0,0,0,0,0,1,0,0,1,0,0,0,0,0,0,0,1,0,0,1,0,0,0,0,0,0,0,0,0,0,1,0,1,0,0,0,0,0,0,0,1,0,0
0,0,0,0,0,0,0,0,0,0,0,0,1,0,0,1,1,1,1,1,1,1,1,1,0,0,1,1,1,1,1,1,1,1,1,0,0,1,0,1,0,0,0,0,0,0,0,1,0,0
0,0,0,0,0,0,0,0,0,0,0,0,1,0,0,0,0,0,0,0,0,0,0,0,0,0,0,0,0,0,0,0,0,0,0,0,0,1,0,1,0,0,0,0,0,0,0,1,0,0
0,0,0,0,0,0,0,0,0,0,0,0,0,1,1,1,1,1,1,1,1,1,1,1,0,0,1,1,1,1,1,1,1,1,1,1,1,0,0,1,0,0,0,0,0,0,0,1,0,0
0,0,0,0,0,0,0,0,0,0,0,0,0,0,0,0,0,0,0,0,0,0,0,0,1,1,0,0,0,0,0,0,0,0,0,0,0,0,0,0,1,1,1,1,1,1,1,0,0,0